10110110
11000011
00011001
10111111
00010011
10111010
10011010
01011110
00011000
10011010
00101110
0000110
